═══════════════════════════════════════════════════════════════════════════════
GROUP 1: ACTIVITIES 1-50
Copy this entire section to ChatGPT
═══════════════════════════════════════════════════════════════════════════════

1. Therme București Wellness Day - București-Ilfov, Bucharest - wellness
2. Peleș Castle Guided Visit - Prahova, Sinaia - culture
3. Bran Castle (Dracula's Castle) Visit - Brașov, Bran - culture
4. Brașov Old Town Walking Tour - Brașov, Brașov - culture
5. Skiing in Poiana Brașov - Brașov, Poiana Brașov - sports
6. Danube Delta Boat Safari from Tulcea - Tulcea, Tulcea - nature
7. Wine Tasting in Dealu Mare - Prahova, Dealu Mare - culinary
8. Transfăgărășan Scenic Day Tour - Sibiu, Sibiu - adventure
9. Turda Salt Mine Underground Park - Cluj, Turda - culture
10. Dimitrie Gusti National Village Museum - Bucharest, Bucharest - culture
11. Bucovina Painted Monasteries Tour - Suceava, Suceava - culture
12. Bear Watching from a Hide (Brașov) - Brașov, Brașov - nature
13. Parc Aventura Brașov Zipline & Ropes - Brașov, Brașov - adventure
14. Black Sea Sea-Kayaking (Mangalia) - Constanța, Mangalia - water
15. Electronic Club Night in Bucharest - București, Bucharest - nightlife
16. Cluj Live Music & Club Night - Cluj, Cluj-Napoca - nightlife
17. Timisoara Club Night - Timiș, Timișoara - nightlife
18. Iași Night Out (Bars & Clubs) - Iași, Iași - nightlife
19. Bucharest Escape Room Challenge - București, Bucharest - social
20. Cluj Escape Room Adventure - Cluj, Cluj-Napoca - social
21. Bucharest Yoga Class (Vinyasa/Hatha) - București, Bucharest - fitness
22. CrossFit Session in Cluj - Cluj, Cluj-Napoca - fitness
23. CrossFit Session in Bucharest - București, Bucharest - fitness
24. Oradea Thermal Aqua Day (Aquaparks) - Bihor, Oradea - wellness
25. Sovata Bear Lake & Spa Day - Mureș, Sovata - wellness
26. Balvanyos Forest Spa Ritual - Covasna, Balvanyos - wellness
27. Black Sea Coastal Kayaking Coaching - Constanța, Constanța - water
28. Wakeboarding Session near Bucharest - Ilfov, Snagov - water
29. Intro to Golf in Transylvania - Cluj, Apahida - sports
30. Romantic Boat Ride on Herăstrău Lake - București, Bucharest - romance
31. Hot Air Balloon Flight near Cluj - Cluj, Cluj-Napoca - romance
32. Christmas Market Sibiu (Piața Mare) - Sibiu, Sibiu - seasonal
33. Christmas Market Cluj-Napoca (Piața Unirii) - Cluj, Cluj-Napoca - seasonal
34. Christmas Market Bucharest (Constitution Square) - București, Bucharest - seasonal
35. Christmas Market Timișoara (Victory Square) - Timiș, Timișoara - seasonal
36. Bucharest Traditional Food Tour - București, Bucharest - culinary
37. Romanian Cooking Class in Bucharest - București, Bucharest - culinary
38. Cluj-Napoca Street Food & Market Tasting - Cluj, Cluj-Napoca - culinary
39. Sibiu Old Town Food Tour - Sibiu, Sibiu - culinary
40. Timișoara Craft Beer Tasting Crawl - Timiș, Timișoara - culinary
41. Gramma Winery Visit & Tasting (Iași) - Iași, Iași - culinary
42. Domeniul Bogdan Organic Winery Tour - Constanța, Peștera - culinary
43. Dealu Mare Winery Trio (Lacerta/Serve/Budureasca) - Prahova, Ceptura - culinary
44. Constanța Seafood Tasting Experience - Constanța, Constanța - culinary
45. Improvisation Theatre Workshop (Bucharest) - București, Bucharest - creative
46. Salsa/Bachata Beginner Class (Bucharest) - București, Bucharest - creative
47. Cyanotype & Alternative Photography Workshop - București, Bucharest - creative
48. Screen Printing Basics (Bucharest) - București, Bucharest - creative
49. Icon on Glass Workshop (ASTRA Museum) - Sibiu, Sibiu - creative
50. Weaving on the Loom (ASTRA Museum) - Sibiu, Sibiu - creative
